GGGGGGGGGGGGGGGGGGGG
GGGGGGGGGGGGGGGGGGGG
GGGGGGGGGGGGGGGGGGGG
GGGGGGGGGGGGGGGGGGGG
GGGGGGGGGGGGGGGGGGGG
GGGGGWWWWWWWWWWGGGGG
GGGGGWGGGGGGGGWGGGGG
GGGGGWGGGGGGGGWGGGGG
GGGGGWGGGGGGWWWGGGGG
GGGGGW1GGVGGG!WGGGGG
GGGGGWGGGGGGWWWGGGGG
GGGGGWGGGGGGGGWGGGGG
GGGGGWGGGGGGGGWGGGGG
GGGGGWGGGGGGGGWGGGGG
GGGGGWWWWWWWWWWGGGGG
GGGGGGGGGGGGGGGGGGGG
GGGGGGGGGGGGGGGGGGGG
GGGGGGGGGGGGGGGGGGGG
GGGGGGGGGGGGGGGGGGGG
GGGGGGGGGGGGGGGGGGGG